11111111111111111111111111111
1P00001000001C1000C0000000001
10111010000000000111111111101
10100000010111110000001010011
111000000C1010011000000000001
100011111100000000C0000000001
1011111111111111111C1000C0011
10001011111111111100000001011
1110000001010000000001C101001
1000E0000000011111110000001C1
11111111111111111111111111111