11111111111111111111111111111
1000001000001C1000C0000000001
10000010000000000111111111101
110000M0010111110000001010011
111000000C1010011000000000001
10001111110P000000C0000000001
1011111111111111111C1000C0011
10001011111111111100000001011
111000001010001000001C1010001
1001E1000000011111110000001C1
11111111111111111111111111111