111111111
111PEC111
111111111
