11111111111111
1C1000C0000001
10000010000001
10111111111111
10000000101111
10000001010001
1000001C101001
10000000000001
1111111000P001
1CEM0000000011
11111111111111