11111111111111
100000C0000001
10000010000001
10111111111111
10000000101111
10111001010001
1000001C101001
100000000M0001
1111111000P001
11E00000000011
11111111111111