11111111111111
10000000000001
10000010000001
10111111111111
10000000101111
10111000010001
10000010101001
100C0000C00001
1111111000P001
11E00000000001
11111111111111